@@@  @@@@@@@@
@WW     W@@@@
@WWW    WW@@@
@WWWW     WW@
@WW~~~~~~   @
@W~~~~~~~    
@W~~~~~~~    
@o~~~~~~~   @
~~~~~~      @
~~~~~       @
@          @@
@ @@@  @@@@@@