@@@@@  @@@@@@
@@@@    @@@@@
@@@@    @@@@@
@@@@@    @@@@
@@@@      @@@
@@@  @@@   @@
@@    @@ WW@@
@    @@@WWWT 
@  @  @@WWW@@
@@     @@WWW@
@@@  @  @#@W@
@@@@   @@@@ @