@@@@@@  @@@@@
@@@@@WWW    @
@WWWWW      @
@WWW         
@@@@@@       
    @@@@    @
     @@    @@
@    @@    @@
@    @@    @@
@     WWW @@@
@@@@WWWW@@@@@
@@@@  @@@@@@@