@@@@@@@@@  @@
@@ ~~       @
@@ ~~  @@@  @
@@          @
@~@     ~~  @
@~~~~   ~~  @
@ ~~~~   @@@@
@           @
@~~  @@   ~~@
@~~     ~~~~@
@      ~~~~~@
@@@  @@@@@@@@