@@  @@@@@@@@@
@@         @@
@@         @@
@@@@T@0@T@@@@
@    @ @    @
@    @ @    @
@   @   @   @
@  @     @  @
@ @       @ @
@  @     @  @
@  #@ o @#  @
@@@@@@@@@@@@@