@@@@@~~@@@@@@
@o  ~~~~~~~~@
@@@0~~~~~~~~@
     ~~~~~~~@
@@@     ~~~~@
            @
@@@        @@
@@@@   WWWW@@
@@@    W@WW@@
       WWWWW@
@@@       WW@
@@@@@  @@@@@@