@ @@@  @@@@@@
@T@@WW     @@
@o@@ WW     @
@@@@W  @    @
@@@WWWW@    @
@@WWWWW@    @
@WWWWW @@   @
@WWW  W@@0T0@
@@@WWW @@   @
@@@@ WW @   @
@@@@@@      @
@@@@@@@@@  @@