@@@  @@@@@@@@
@@@ WW@@@@@@@
   @W    @WW@
    @@@  WWW@
@     @@   W@
@ @@   @     
@            
@0@@@@      @
@ @WWW     @@
@ @WWWWW   @@
@#WWW@@WWWW@@
@@@@@@@@WW@@@