@@@@@  @@@@@@
          @@@
@    @@    @@
@   @@@     @
     @@     @
@    @@WWWW @
@@   @  WWW@@
@@WWW@WWW @@@
@WWW@@ W @@@@
@WW@@   @@@@@
 WW    @@@@@@
@@@@@@@@@@@@@