@@@@@~~@@@@@@
@o  ~~~~~~~~@
@@@0~~~~~~~~@
 WWWW~~~~~~~@
@@@WW W ~~~~@
    WWWW    @
@@@        @@
@@@@   WWWW@@
@@@    W@WW@@
       WWWWW@
@@@       WW@
@@@@@  @@@@@@