@@@@@@@@@@@@@
@@  T  @    @
@ T   @@0@@ @
@     @   @#@
@T T  @ @ @@@
@@ T  0 @    
@@@  T@ @ @@@
@@@@@@@   @W@
@WWWW@@@0@@W@
@WWWWWW@ @WW@
@o>WWWWWWWWW@
@@@@@@@@@@@@@