@@@@@@@@  @@@
@@@@        @
@@@         @
@          @@
@            
~~~    @    @
~~~   @@     
~~~    @   @@
@W          @
@WW         @
@@WW@   @  @@
@@@@@   @@@@@