@@@@@@@  @@@@
@@@         @
@@      ~~~ @
@   @ @ ~~~#@
~~~~~ ~~~~~~~
~~~~~ ~~~~~~~
@ ^ @ @WWWWW@
@        WWW@
@W      WWWW@
@WWW    W   @
@W          @
@@  @@@@@@@@@