@@@@@   @@@@@
@WW @ @ @ @ @
@ @   @     @
@ @@@@@ @@@W@
@W  @ @ 0 @ @
@@@ @ @ @ @W@
@#@ @ @@@ @ @
@  WWW @ W  @
@@@@@@   @@W@
@@ WWW@@T@WW 
@@00@     W@@
@@  @@@@@@@@@