@@@@@@@@@@@@@
@@@        o@
@@@ @@@@@@@@@
@@@ @@@@@@@@@
@@@ @@@@@@@@@
@@@ @@@@@@@@@
@@@ @@@@@@@@@
@@@ @@@@@@@@@
@@@ @@@@@@@@@
     @@@@@@@@
     @@@@@@@@
@@@  @@@@@@@@