@@@@@@@@@@@@@
@@  T  @    @
@ T   @@0@@ @
@     @   @o@
@T T  @ @ @@@
@@ T  0 @    
@@@  T@ @ @@@
@@@@@@@   @W@
@WWWW@@@0@@W@
@WWWWWW@ @WW@
@oWWWWWWWWWW@
@@@@@@@@@@@@@