@@@@@@@@@@@@@
@@@        #@
@@@ @@@@@@@@@
@@@ @@@@@@@@@
@@@ @@@@@@@@@
@@@ @@@@@@@@@
@@@ @@@@@@@@@
@@@ @@@@@@@@@
@@@ @@@@@@@@@
     @@@@@@@@
     @@@@@@@@
@@@  @@@@@@@@