@@@@O   O@@@@
@@  O   O  @@
@         WW@
@ @@     @WW@
@o@@     @@@@
@@@     @@@@@
@@@    @@@@@@
       @@@@@@
        @@@@@
@@@@@        
@@@@@@@      
@@@@@@@@@@@@@