@@@@@@@@@@@@@
@@@        >@
@@@ @@@@@ @@@
@@@ @@@@@  o@
@@@ @@@@@@@@@
@@@ @@@@@@@@@
@@@ @@@@@@@@@
@@@ @@@@@@@@@
@@@ @@@@@@@@@
     @@@@@@@@
     @@@@@@@@
@@@  @@@@@@@@