@@@@@@@@@@@@@
@@ W o  @ ~W@
@ W @  ~  @ @
@ ~~ W WW   @
@  @ ~  @ ~ @
@WW  WW W @ @
@ @ ~W@   W @
@WW    ~W @ @
@ ~W@ @ W ~ @
    W  @   ~@
@ @@ @W  WW @
@@@@@@@@@@@@@