@@@@@@@@@@@@@
@@@@@WWWWW@@@
@@@WWWWW  W@@
@ WW   WWW W@
  WWWWW WWW @
@@@@@@@@@@@T@
    @@@@@    
@            
@~~@~@~@~@~~@
@~~~~~~~~~~~@
@~~~@~@~@~~~@
@@@@@@@@@@@@@