@@@@@@@@@@@@@
@@@WWW    @@@
@WWWWW@@ #@@@
@WWWW@@@@@@@@
@WWW @@     @
@            
@            
@@          @
@@@     WWWW@
@@@@WWW    @@
@@@@WWWWWW@@@
@@@@WW@@@@@@@