@@@[]___[]@@@
@           @
@ O       O @
@           @
@ O       O @
@           @
@ O       O @
@           @
@           @
@@ O     O @@
@@@       @@@
@@@@O   O@@@@