@@@@   @@@@ @
@@@       @ @
@@      @@@ @
@   @@  @ 0 @
@W@@@@WW@ @@@
@WW@@WWW@  o@
@WW @ W @@@@@
@  W        @
@      O   O@
@@       $  @
@@@    O   O@
@@@@@@@@@@@@@