@@@@@@@@@@@@@
@@@@@@@@@@@@@
@@@@@@@@@@@@@
@@@    @@@@@@
@@        @@@
@      WW   @
    ~~~~WW  @
    ~~~~W@@T@
@   ~~~~WW@ @
@      @WWW @
@@     @W@@o@
@@@@@  @@@@@@