@@@@@@@@@@@@@
@            
@ @@@@@@@@@@@
@ @@@W #@@@@@
@W@WWW@@@    
@WWWW   @ @ @
@@@@@@@@@ @ @
@       @@@ @
@ @@@@@     @
@ @ @ @@@@@@@
@o@          
@@@@@@@@@@@@@