@@@@@@@@@@@@@
@@@   @ @    
@   @  @  @ @
@ @ @   @  @@
@    @      @
@  @    @ @ @
@@  @@@  @  @
@ @     @  @@
@   @    @  @
@@@    @  @ @
@o  @   @   @
@@@@@  @@@@@@