@@@  @@@@@@@@
@           @
@ @@@@@@@@@ @
@  @        @
@@@@ @@W@@@ @
  @@ @WW@   @
@ @@ @WW@ @W@
@ @@@@ @@ @W@
@ T    @@@@W@
@@@ @@@@@WWW@
@   WW    @ @
@@@@@@@@  @@@