@@@@@@  @@@@@
@@@@@   @   @
@@@    @@@@ @
@@    WWWW@  
@   @@@@@@@@@
@  @@@@      
@@  @@@  @@@@
@@@  @  @@@@@
@@@  @  @@@@@
@@@      T   
@@@@@@@@@@@@@
@@@@@@@@@@@@@