@@@@@@@@@@@@@
@       @@@@@
@ W @  WWW@@@
@WW@@@WWWW@@@
@W  o@WWWWWW@
@@@@@@@WWWW @
       W    @
            @
@           @
@ WWWW@@@@@@@
@@@@@@@@@@@@@
@@@@@@@@@@@@@