@@@@@@@@@@@@@
@@@@@@@@@@@@@
@@~~~~~~~~~~@
@~~~~~~~~~~~@
@~~~~~~~~~~~@
             
@~~~~        
@~~~~~~~~~~~@
@~~~~~~~~~~~@
@~~~~~~~~~~@@
@@@@@@@@@@@@@
@@@@@@@@@@@@@