@@@@@@@@@@@@@
@@@@@@@@@@@@@
@WWWW@@@  @@@
@WWWW@@   @@@
@WW  @@   WW@
@         WW@
     v   WWW@
          WW@
@@@@     WWW@
@@@@@    W@@@
@@@@@   @@@@@
@@@@@@@@@@@@@