@@@@@@@@@@@@@
@#0 @   @   @
@W@ @ @   @ @
@W@   @@@@W @
@W@@ @@@WWW@@
@WWWW  @@@WW@
@@@@@@ @ @W @
     @ @ @TT@
@@ @ @   @  @
@@ @   @@@  @
@    @@@   @@
@@@@@@@@ @@@@