@@@@@@@@ @@@@
@@@@        @
@@@ W     @ @
@@WW     @@0@
@WW W   @@@  
@WWW @W@@@@  
@W@ WWW @@@  
@W@@ W   @@@@
@W@@~~~~  @@@
@@~~~~~~~  o@
@@@~~~~~~~@@@
@@@@@@@@@@@@@