@@@@@@@@@@@@@
@@@@@@@@@@@@@
@WWWW@@@  @@@
@WWWW@@   @@@
@WW @@@   WW@
@    v    WW@
         WWW@
          WW@
@@@@     WWW@
@@@@@    W@@@
@@@@@   @@@@@
@@@@@@@@@@@@@