@@@@@@@@@@@@@
@@@     @@@@@
@@@T@@   @@@@
  @ @@@   @@@
    @@@@   @@
@   @@WW    @
@   @@@WWW  @
@   @@@@WW   
@  @@ WWWWW  
@  @WWW@@@@@@
@  WW@@@@@@@@
@@@@@@@@@@@@@