@@@  @@@@@@@@
@@@     ~~~~@
@       ~~~~@
@       ~~~~@
@           @
@           @
@           @
@           @
@           @
@           @
@           @
@@@@@@@@@@  @