@@@  @@@@@@@@
@@@  @@@@@@@@
@@@  @@@@@@@@
@@@          
@@   @@@@@@@@
@@@          
@@   @@@@@@@@
@@@          
@@   @@@@@@@@
@@@          
@@@@@@@@@@@@@
@@@@@@@@@@@@@