@@@@@@@@@@@@@
@@@@@@@@@@   
@@@@@@@@@@ @@
@@@@@@@@@@ @@
  WWWWWWW@ @@
  WWWWWWWT @@
  WWWWWWW@@@@
@ @@@@@@@@@@@
@ @@@@@@@@@@@
@ @@@@@@@@@@@
@            
@@@@@@@@@@@@@