@@@  @@@@@@@@
@@@     ~~~~@
@    W  ~~~~@
@  WWWW ~~~~@
@W  @@ WWWWW@
@WWW @@WW   @
@WWWW   W   @
@ WWWW  W @@@
@ @WWWW    @@
@ @@@@@@    @
@      #@   @
@@@@@@@@@@  @