@@@@@@@@@@  @
@o  @   @@  @
@@@   @  T  @
@@@@@@@@@@  @
@@@WWW W  W @
@WWWW  WWW  @
@WW    WW  W@
    WWWW     
    WWWWW    
@   @@@     @
@@@      @@@@
@@@@@@@@@@@@@