@@@@@@@@@@@@@
@@@@@@@@@@@@@
@@@@@@WW@@@@@
@WWWWWWWW  T 
@WWW W    @@@
@@@@@@@ W@@@@
       WWWW  
       WW@@@@
@   @    @@@@
@@       @o  
@@@      @@@@
@@@@@  @@@@@@