@@@@@@@WW@@@@
@@   @@W  @@@
@  @ WWW@  @@
@ @@ @@@@@ @@
@ @@       @@
@   @@@@@@@@@
@@@    W   @@
  @@@0@W@@  @
  @   @W@@@ @
@ @ @   @@@ @
@   @@@     @
@@@@@@@@@@@@@