@@@@  @@@@@@@
@@@    @@@@@@
@@@     @@@@@
         @@@@
@@@      W@@@
@@@      WW@@
         @@@@
@@@WW   @@@@@
@@@WWW  @@@@@
 WWWWWW@@@@@@
@@@@@@@@@@@@@
@@@@@@@@@@@@@