@@@@@@@@@@@@@
@o  T    @@@@
@   @       @
@0@@@     WW 
@        WWW 
@@@@@@@   @@@
@@@@@WWW@@@@@
@@@@WW@@@@@@@
@@@@   @@@@@@
@WWWW   @@@@@
@@@WWWWWWWWW@
@@@@@@@WW@@@@