@@@@     @@@@
@   O   O   @
@           @
@  @     @  @
@@@@     @@@@
@  @        @
@ @@@@@@@@@ @
@ @@@@@@@@@ @
@    @@     @
@@@  @@  @@@@
@@@  @@  @@@@
@@@  @@  @@@@