@@@@@@@@@@@@@
  ~o ~ ~~~  @
@~~~ ~     ~@
@    ~~~~~ ~@
@ ~~~ ~  ~  @
@         ~ @
@~~~~~~~~ ~ @
@~    ~ ~ ~ @
@~ ~~   ~   @
@~ ~  ~~~ ~~@
   ~~       @
@@@@@@@@@@@@@