@@@@@@  @@@@@
@@@@@@  @@@@@
@@@@@@  @@@@@
@@@@@@  @@@@@
@@@@@@  @@@@@
@@@@@@  @@@@@
@@@@@@       
@@@@@@#      
@@@@@@@@@@@@@
@@@@@@@@@@@@@
@@@@@@@@@@@@@
@@@@@@@@@@@@@