@@@@@  @@@@~~
@@@@@TT@WW@~~
@        W@  
    @   WWWW@
    @@@@@  W@
@   @@@@@@ W@
@   @WWW#@  @
@   @WWWW@  @
@   @WWWW@  @
@   WWWWWW   
@            
@@@@@@@@@@@@@