@@@@  @@@@@@@
@@@W        @
@@@WW       @
@@@@@@@@WW  @
@@      W W @
@    @@@@@@@@
@  @@@      @
@ WWW@ @@@WW@
@WWWW@ @WWWW@
@WW    @WWWo@
@@@@@TT@@@@@@
@@@@@  @@@@~~