@@@@@@@  @@@@
@o 0000  @@@@
@ @@@@@  @@@@
@ W@   @W  @@
@@ @ @ @@@  @
@  @ @W     @
@ @@ @@@@@@@@
@  @     @@@@
@@W@@@@@    @
@  @  W@@@@ @
@    @   W  @
@@@@@@@@@@@@@