~~~~~~~~~~~~~
~~~~~~~~~~~~~
   o@      T 
@@@@@      @@
@           @
@WW@@@@@@@WW@
@W @#    @WW@
@ W@@@@@ @W @
@ W      @ W@
   WW@@@@@W @
   WWWW   WW@
@@@@@@@  @@@@