~~~~~~~~~~~~~
~~~~~~~~~~~~~
          >~~
@          ~~
@@@@@@@@@TT~~
@          ~~
@  #    o  ~~
@          ~~
@  o    o  ~~
@          @@
@@@@@@@@@@@@@
@@@@@@@@@@@@@