@@@@@@@@@@@@@
@           @
@           @
@           @
@           @
@           @
@           @
@           @
@           @
@           @
@           @
@@@@@@@@@@@@@